E;E;E;E;E;E;E;E;E;E;E;E;E;E;E;E;E;E;E;E;E;E;E;E;E;E;E;V;V;V;E;E;E;E;E;E;E;E;E;E;E;E;E;E;E;E;E;E;E;E;E;E;E;E;E
E;E;E;E;E;E;E;E;E;E;E;E;E;E;E;E;E;E;E;E;E;E;E;E;E;E;E;V;V;V;E;E;E;E;E;E;E;E;E;E;E;E;E;E;E;E;E;E;E;E;E;E;E;E;E
E;E;E;E;E;E;E;E;E;E;E;E;E;E;E;E;E;E;E;E;E;E;E;E;E;E;E;V;V;V;E;E;E;E;E;E;E;E;E;E;E;E;E;E;E;E;E;E;E;E;E;E;E;E;E
E;E;E;E;E;E;E;E;E;E;E;E;E;E;E;E;E;E;E;E;E;E;E;E;E;E;E;V;V;V;E;E;E;E;E;E;E;E;E;E;E;S;E;E;E;E;E;E;E;E;E;E;E;E;E
E;E;E;E;E;E;E;E;E;E;E;E;E;E;E;E;E;E;E;E;E;E;E;E;E;E;E;V;V;V;E;E;E;E;E;E;E;E;E;E;E;S;S;E;E;E;E;E;E;E;E;E;E;E;E
E;E;E;E;E;E;E;E;E;E;E;E;E;E;E;E;E;E;E;E;E;E;E;E;E;E;E;E;V;V;V;E;E;E;E;E;E;E;E;E;E;S;S;E;E;E;E;E;E;E;E;E;E;E;E
E;E;E;E;E;E;E;E;E;E;E;E;E;E;E;E;E;E;E;E;E;E;E;E;E;E;E;E;V;V;V;E;E;E;E;E;E;E;E;E;E;E;S;S;E;E;E;E;E;E;E;E;E;E;E
E;E;E;E;E;E;E;E;E;E;E;E;E;E;E;E;E;E;E;E;E;E;E;E;E;E;E;E;V;V;V;E;E;E;E;E;E;E;E;E;E;E;E;S;E;E;E;E;E;E;E;E;E;E;E
E;E;E;E;E;E;E;E;E;E;E;E;E;E;E;E;E;E;E;E;E;E;E;E;E;E;E;E;V;V;V;E;E;E;E;E;E;E;E;E;E;E;E;S;E;E;E;E;E;E;E;E;E;E;E
E;E;E;E;E;E;E;E;E;E;E;E;E;E;E;E;E;E;E;E;E;E;E;E;E;E;E;E;V;V;V;E;E;E;E;E;E;E;E;E;E;E;E;E;E;E;E;E;E;E;E;E;E;E;E
E;E;E;E;E;E;E;E;E;E;E;E;E;E;E;E;E;E;E;E;E;E;E;E;E;E;E;E;V;V;V;E;E;E;E;E;E;E;E;E;E;E;E;E;E;E;E;E;E;E;E;E;E;E;E
E;E;E;E;E;E;E;E;E;E;E;E;E;E;E;E;E;E;E;E;E;E;E;E;E;E;E;E;V;V;V;E;E;E;E;E;E;E;E;E;E;E;E;E;E;E;E;E;E;E;E;E;E;E;E
E;E;E;E;E;E;E;E;E;E;E;E;E;E;E;E;E;E;E;E;E;E;E;E;E;E;E;E;V;V;V;E;E;E;E;E;E;E;E;E;E;E;E;E;E;E;E;E;E;E;E;E;E;E;E
E;E;E;E;E;E;E;E;E;E;E;E;E;E;E;E;E;E;E;E;E;E;E;E;E;E;E;E;V;V;V;E;E;E;E;E;E;E;E;E;E;E;E;E;E;E;E;E;E;E;E;E;E;E;E
E;E;E;E;E;E;E;E;E;E;E;E;E;E;E;E;E;E;E;E;E;E;E;E;E;E;E;E;E;V;V;V;E;E;E;E;E;E;E;E;E;E;E;E;E;E;E;E;E;E;E;E;E;E;E
E;E;E;E;E;E;E;E;E;E;E;E;E;E;E;E;E;E;E;E;E;E;E;E;E;E;E;E;E;E;V;V;V;E;E;E;E;E;E;E;E;E;E;E;E;E;E;E;E;E;E;E;E;E;E
E;E;E;E;E;E;E;E;E;E;E;E;E;E;E;E;E;E;E;E;E;E;E;E;E;E;E;E;E;E;V;V;V;V;E;E;E;E;E;E;E;E;E;E;E;E;E;E;E;E;E;E;E;E;E
E;E;E;E;E;E;E;E;E;E;E;E;E;E;E;E;E;E;S;S;S;E;E;E;E;E;E;E;E;E;V;V;V;V;E;E;E;E;E;E;E;E;E;E;E;E;E;E;E;E;E;E;E;E;E
E;E;E;E;E;E;E;E;E;E;E;E;E;E;E;E;E;E;S;S;S;E;E;E;E;E;E;E;E;E;E;V;V;V;E;E;E;E;E;E;E;E;E;E;E;E;E;E;E;E;E;E;E;E;E
E;E;E;E;E;E;E;E;E;E;E;E;E;E;E;E;E;E;S;S;S;v;E;E;E;E;E;E;E;E;E;V;V;V;E;E;E;E;E;E;E;E;E;E;E;E;E;E;E;E;E;E;E;E;E
E;E;E;E;E;E;E;E;E;E;E;E;E;E;E;E;E;E;E;S;S;S;E;E;E;E;E;E;E;E;E;V;V;V;E;E;E;E;E;E;E;E;E;E;E;E;E;E;E;E;E;E;E;E;E
E;E;E;E;E;E;E;E;E;E;E;E;E;E;E;E;E;E;E;E;E;E;E;E;E;E;E;E;E;E;E;V;V;V;E;E;E;E;E;E;E;E;E;E;E;E;E;E;E;E;E;E;E;E;E
E;E;E;E;E;E;E;E;E;E;E;E;E;E;E;E;E;E;E;E;E;E;E;E;E;E;E;E;E;V;V;V;E;E;E;E;E;E;E;E;E;E;E;E;E;E;E;E;E;E;E;E;E;E;E
E;E;E;E;E;E;E;E;E;E;E;E;E;E;E;E;E;E;E;E;E;E;E;E;E;E;E;E;E;V;V;V;E;E;E;E;E;E;E;E;E;E;E;E;E;E;E;E;E;E;E;E;E;E;E
E;E;E;E;E;E;E;E;E;E;E;E;E;E;E;E;E;E;E;E;E;E;E;E;E;E;E;V;V;V;V;V;E;E;E;E;E;E;E;E;E;E;E;E;E;E;E;E;E;E;E;E;E;E;E
E;E;E;E;E;E;E;E;E;E;E;E;E;E;E;E;E;E;E;E;E;V;V;V;V;V;V;V;V;V;V;V;E;E;E;E;E;E;E;E;E;E;E;E;E;E;E;E;E;E;E;E;E;E;E
E;E;E;E;E;E;E;E;E;E;E;E;E;E;E;E;E;E;E;V;V;V;V;V;V;V;V;V;V;V;S;V;E;E;E;E;E;E;E;E;E;E;E;E;E;E;E;E;E;E;E;E;E;E;E
E;E;E;E;E;E;E;E;E;E;E;E;E;E;E;E;E;E;E;V;V;V;V;V;V;V;V;E;E;E;S;V;E;E;E;E;E;E;E;E;E;E;E;E;E;E;E;E;E;E;E;E;E;E;E
E;E;E;E;E;E;E;E;E;E;E;E;E;E;E;E;E;E;V;V;V;V;E;E;E;E;E;E;E;E;S;V;E;E;E;E;E;E;E;E;E;E;E;E;E;E;E;E;E;E;E;E;E;E;E
E;E;E;E;E;E;E;E;E;E;E;E;E;E;E;E;E;E;V;V;V;E;E;E;E;E;E;E;E;E;E;V;E;E;E;E;E;E;E;E;E;E;E;E;E;E;E;E;E;E;E;E;E;E;E
E;E;E;E;E;E;E;E;E;E;E;E;E;E;E;E;E;E;V;V;V;E;E;E;E;E;E;E;E;E;V;V;E;E;E;E;E;E;E;E;E;E;E;E;E;E;E;E;E;E;E;E;E;E;E
E;E;E;E;E;E;E;E;E;E;E;E;E;E;E;E;E;E;V;V;E;E;E;E;S;E;E;E;E;V;V;E;E;E;E;E;E;E;E;E;E;E;E;E;E;E;E;E;E;E;E;E;E;E;E
E;E;E;E;E;E;E;E;E;E;E;E;E;E;E;E;E;E;E;E;E;E;E;S;S;S;E;E;E;V;E;E;E;E;E;E;E;E;E;E;E;E;E;E;E;E;E;E;E;E;E;E;E;E;E
E;E;E;E;E;E;E;E;E;E;E;E;E;E;E;E;E;E;E;E;E;E;E;S;S;S;E;E;E;V;E;E;E;E;E;E;E;E;E;E;E;E;E;E;E;E;E;E;E;E;E;E;E;E;E
E;E;E;E;E;E;E;E;E;E;E;E;E;E;E;E;E;E;V;V;E;E;E;S;S;E;E;E;V;V;E;E;E;E;E;E;E;E;E;E;E;E;E;E;E;E;E;E;E;E;E;E;E;E;E
E;E;E;E;E;E;E;E;E;E;E;E;E;E;E;E;E;E;V;V;V;E;E;E;S;E;E;V;V;E;E;E;E;E;E;E;E;E;E;E;E;E;E;E;E;E;E;E;E;E;E;E;E;E;E
E;E;E;E;E;E;E;E;E;E;E;E;E;E;E;E;E;E;V;V;V;E;E;E;S;E;E;E;E;E;E;E;E;E;E;E;E;E;E;E;E;E;E;E;E;E;E;E;E;E;E;E;E;E;E
E;E;E;E;E;E;E;E;E;E;E;E;E;E;E;E;E;E;V;V;V;E;E;E;S;E;V;V;E;E;E;E;E;E;E;E;E;E;E;E;E;E;E;E;E;E;E;E;E;E;E;E;E;E;E
E;E;E;E;E;E;E;E;E;E;E;E;E;E;E;E;E;E;V;V;V;E;E;E;E;E;V;E;E;E;E;E;E;E;E;E;E;E;E;E;E;E;E;E;E;E;E;E;E;E;E;E;E;E;E
E;E;E;E;E;E;E;E;E;E;E;E;E;E;E;E;E;E;E;V;V;V;E;E;E;E;V;E;E;E;E;E;E;E;S;S;S;E;E;E;E;E;E;E;E;E;E;E;E;E;E;E;E;E;E
E;E;E;E;E;E;E;E;E;E;E;E;E;E;E;E;E;E;E;V;V;V;V;E;S;S;V;V;E;E;E;E;E;E;S;S;S;S;E;E;E;E;E;E;E;E;E;E;E;E;E;E;E;E;E
E;E;E;E;E;E;E;E;E;E;E;E;E;E;E;E;E;E;E;V;V;V;V;V;V;V;V;V;E;E;E;E;E;E;S;S;S;S;E;E;E;E;E;E;E;E;E;E;E;E;E;E;E;E;E
E;E;E;S;S;E;E;E;E;E;E;E;E;E;E;E;E;E;E;E;V;V;V;V;V;V;V;V;V;E;E;E;E;E;E;E;E;S;E;E;E;E;E;E;E;E;E;E;E;E;E;E;E;E;E
E;E;E;S;S;S;E;E;E;E;E;E;E;E;E;E;E;E;E;E;E;E;V;V;V;V;V;V;V;E;E;E;E;E;E;E;E;E;E;E;E;E;E;E;E;E;E;E;E;E;E;E;E;E;E
E;E;E;S;S;S;E;E;E;E;E;E;E;E;E;E;E;E;E;E;E;E;E;E;E;E;V;V;V;V;E;E;E;E;E;E;E;E;E;E;E;E;E;E;E;E;E;E;E;E;E;E;E;E;E
E;E;E;E;E;E;E;E;E;E;E;E;E;E;E;E;E;E;E;E;E;E;E;E;E;E;E;V;V;V;V;V;E;E;E;E;E;E;E;E;E;E;E;E;E;E;E;E;E;E;E;E;E;E;E
E;E;E;E;E;E;E;E;E;E;E;E;E;E;E;E;E;E;E;E;E;E;E;E;E;E;E;V;V;V;V;V;E;E;E;E;E;E;E;E;E;E;E;E;E;E;E;E;E;E;E;E;E;E;E
E;E;E;E;E;E;E;E;E;E;E;E;E;E;E;E;E;E;E;E;E;E;E;E;E;E;E;E;E;V;V;V;V;E;E;E;E;E;E;E;E;E;E;E;E;E;E;E;E;E;E;E;E;E;E
E;E;E;E;E;E;E;E;E;E;E;E;E;E;E;E;E;E;E;E;E;E;E;E;E;E;E;E;E;E;V;V;V;E;E;E;E;E;E;E;E;E;E;E;E;E;E;E;E;E;E;E;E;E;E
E;E;E;E;E;E;E;E;E;E;E;E;E;E;E;E;E;E;E;E;E;E;E;E;E;E;E;E;E;E;V;V;V;E;E;E;E;E;E;E;E;E;E;E;E;E;E;E;E;E;E;E;E;E;E
E;E;E;E;E;E;E;E;E;E;E;E;E;E;E;E;E;E;E;E;E;E;E;E;E;E;E;E;E;V;V;V;E;E;E;E;E;E;E;E;E;E;E;E;E;E;E;E;E;E;E;E;E;E;E
E;E;E;E;E;E;E;E;E;E;E;E;E;E;E;E;E;E;E;E;E;E;E;E;E;E;E;E;E;V;V;V;E;E;E;E;E;E;E;E;E;E;E;E;E;E;E;E;E;E;E;E;E;E;E
E;E;E;E;E;E;E;E;E;E;E;E;E;E;E;E;E;E;E;E;E;E;E;E;E;E;E;E;E;V;V;V;E;E;E;E;E;E;E;E;E;E;E;E;E;E;E;E;E;E;E;E;E;E;E
E;E;E;E;E;E;E;E;E;E;E;E;E;E;E;E;E;E;E;E;E;E;E;E;E;E;E;E;E;V;V;E;E;E;E;E;E;E;E;E;E;E;E;E;E;E;E;E;E;E;E;E;E;E;E
E;E;E;E;E;E;E;E;E;E;E;E;E;E;E;E;E;E;E;E;E;E;E;E;E;E;E;E;E;V;V;E;E;E;E;E;E;E;E;E;E;E;E;E;E;E;E;E;E;E;E;E;E;E;E
